14	7
10	10	10	10	10	9	9	9	9	10	10	10	10	10
10	10	10	10	9	9	9	9	9	9	10	10	10	10
10	10	9	9	9	9	9	9	9	9	9	9	10	10
10	10	9	9	9	9	9	9	9	9	9	9	10	10
10	10	9	9	9	9	9	9	9	9	9	9	10	10
10	10	10	10	9	9	9	9	9	9	10	10	10	10
10	10	10	10	10	9	9	9	9	10	10	10	10	10
LeftMon=51018001;2;3
RightMon=51018001;11;3
TowerStar=2
ColumnMiddle=6;7
ColumnCompete=5;8